---------------------XXXX------------oSS------------------------------------------------------------
-------------------------------------SSSooo---------------------------------------------------------
------SS-----------------------------SSSSSS---------------------------------------------------------
---------XX--------------------------SSSSSS----------------------------?--------------------------SS
-------------------------------------SSSSSS-------------------------------------------------------SS
--------QQQQX----------------------SS----------------------------------------------X--------------SS
---------[]-X--------o------------E------------------------------------------------XE---------------
------XXXXXXX--------------------<>-----------------------------E-----------------------------------
---<>----------------------------[]--------------------------?QQ------------------------------------
---[]----------------------------[]--------------------------------------S--------------------------
---<>----------------------------[]--------------------------------------S--------------------------
---[]---------------------BE-XXX-[]----------------------------------------------------X--------X--S
---[]--------------XXXXXXXXXXXXX-[]----------------------------------------------------X-----------S
-XXXXXXX---------XXXXXXXXXXXXXXXXXXXXXXXXX----------EEE----E------------------------XXXX------------
XXXXXXXXX--------XXXXXXXXXXXXXXXXXXXXXXXXXXXXXXXXXXXXXXXXXXXX-------------------XXXXXXXX------------
