----------[-------------------------------QQQQ--------------------------------------------------S---
----------QSSSSSSSSSSSSS-------------------------------------------------------------------------E--
----------------------------------------------------------------------------------------------------
----------------------------------------------------------------------------------------------------
------------------------------------------------------------------------------------Q---------------
-----------------------------------------------------------------o----------------------------------
--------------SS---XX-----------------------------------------------------QQQQQQ--------------------
-----------------------------------------------------------QQQQS----------------?-------------------
---------------------------------------------------------------------------------------------o------
----------------------------------------------E----------------------SSS?---------------------------
-----------------------------------E---------<>------------------------------------------SSSSSS-----
---------oooo-EE------------------<>---------[]-----------------------------------------------------
--------------XX---ooooooooo------[]---------XXXXXXXX-----------------?-----------------------------
-X-------E----XX---XXXXXXXXX---E--XXXXXXXXXXXXXXXXXXX--------------------------------------XXXXXXXXX
XX--XXXXXXXXXXXXXXXXXXXXXXXX---XXXXXXXXXXXXXXXXXXXXXXXXXXXXXXXXXXXXXXX---------------------XXXXXXXXX
